00000000000000000000000000000000000000000000000000000000000000000000000000000000000
00000000000000000000000000000000000000000000000000000000000000000000000000000000000
00000000000000000000000000000000000000000000110000000000000000000000000000000000000
00000000000000000000000000000000000000000000000000000000000011111111111111111111111
00000000000000000000000000000000111111111100000000111000000010000000000000000000000
00000000000001111100011100000000100000000100000000000000000010000000000000000000000
10000000001111001000000000001000100000000100000000000000000010000000000000000000000
11000000011000001000000000010000100000000155555555555555555510000000000000000000000
01100000110000001000000000100000100000000000000000000000000000000000000000000000000
00111111100000001444444444444444100000000000000000000000000000000000000000000000000